-------------
    |       |
-   -----   -
|       |   |
-----   -   -
|           
-------------
