-----------------------------------------
    |           |                       |
-   -   -----   -   -----------------   -
|   |   |       |   |           |       |
-   -   -   -----   -   -----   -   -----
|       |           |   |   |       |   |
---------------------   -   ---------   -
|               |   |   |               |
-----   -----   -   -   -   ---------   -
|       |       |   |       |       |   |
-   -----   -----   ---------   -   -   -
|   |       |               |   |       |
-   -----   -------------   -   ---------
|       |               |   |   |       |
-   -   -------------   -   -   -----   -
|   |   |           |       |   |       |
-----   -   -----   -   -----   -   -----
|       |       |       |       |       |
-   ---------------------   ---------   -
|                                       
-----------------------------------------
