-----------------------------------------------------------------
            |           |   |   |   |               |           |
-   -   -   -   -   -   -   -   -   -----------------------------
|   |       |   |   |           |               |           |   |
-   -   -   -   -   -   -   -   -   -   -   ---------------------
|   |           |   |   |   |   |       |           |           |
-   -   -   -   -   -   -----------------------------------------
|       |   |   |                   |   |           |       |   |
-   -   -   -   -   -   -   -------------------------------------
|       |   |           |               |   |   |   |           |
-   -   -   -   -   -   -   -   ---------------------------------
|       |           |   |   |       |   |       |       |   |   |
-   -   -   -   -   -   -   -   -   -   -------------------------
|   |       |               |   |       |       |       |       |
-   -   -   -   -   -   -   -   ---------------------------------
|           |       |   |   |   |                   |           |
-   -   -   -   -   -   -   -------------------------------------
|   |   |       |   |   |           |       |   |       |       |
-   -   -   -   -   -   -   -------------------------------------
|   |       |   |   |           |       |           |   |   |   |
-   -   -   -   -   -   -   -   ---------------------------------
|           |   |       |   |           |   |               |   |
-   -   -   -   -   -   -   -------------------------------------
|                                   |   |       |   |   |       |
-   -   -   -   -   -   -   -   -   -----------------------------
|       |   |           |   |   |   |       |   |       |       |
-   -   -   -   -   -   -   -   ---------------------------------
|   |   |       |           |       |       |           |   |   |
-   -   -   -   -   -   -   -   -   -----------------------------
|   |       |   |       |       |           |   |       |   |   |
-   -   -   -   -   -   -   -   -   -   -------------------------
|       |   |       |   |                   |                   |
-   -   -   -   -   -   -   -------------------------------------
|       |       |   |       |   |           |   |               |
-   -   -   -   -   -   -----------------------------------------
|               |           |   |                       |   |   |
-   -   -   -   -   -   -   -   -   -   -------------------------
|   |   |       |   |               |       |       |       |   |
-   -   -   -   -   -   -----------------------------------------
|           |   |       |   |   |               |       |       |
-   -   -   -   -   -   -   -------------------------------------
|   |       |           |                       |   |   |       |
-   -   -   -   -   -   -   -------------------------------------
|   |       |           |   |   |       |       |   |           |
-   -   -   -   -   -   -   -------------------------------------
|       |       |           |           |   |   |       |       |
-   -   -   -   -   -   -   -   ---------------------------------
|       |           |       |   |   |   |   |       |   |       |
-   -   -   -   -   -   -   -   -   -   -------------------------
|           |       |       |   |       |           |       |   |
-   -   -   -   -   -   -   -   ---------------------------------
|       |       |           |       |           |       |       |
-   -   -   -   -   -   -   -------------------------------------
|           |           |   |   |           |   |       |   |   |
-   -   -   -   -   -   -   -------------------------------------
|       |           |   |           |   |   |   |           |   |
-   -   -   -   -   -   -----------------------------------------
|   |           |           |               |           |       |
-   -   -   -   -   -   -   -   ---------------------------------
|   |       |       |           |       |   |   |   |   |       |
-   -   -   -   -   -   -   -------------------------------------
|   |                   |           |               |       |   |
-   -   -   -   -   -   -   -------------------------------------
|   |   |   |   |   |   |   |   |           |                   |
-   -   -   -   -   -   -   -   -   -----------------------------
|       |       |   |   |           |       |   |   |   |   |   |
-   -   -   -   -   -   -   -   -   -----------------------------
|   |       |           |               |                   |   |
-   -   -   -   -   -   -   -------------------------------------
|   |       |       |   |           |       |           |       |
-   -   -   -   -   -   -   -   ---------------------------------
|       |       |                   |       |   |       |       |
-   -   -   -   -   -   -   -   ---------------------------------
|   |       |   |   |   |       |       |           |       |   |
-   -   -   -   -   -   -----------------------------------------
|   |   |       |           |   |   |   |   |   |           |   |
-   -   -   -   -   -   -   -   -   -   -   -   -----------------
|       |   |           |           |   |   |   |       |       |
-   -   -   -   -   -   -   -------------------------------------
|       |   |   |       |   |           |   |           |       |
-   -   -   -   -   -   -   -   -   -   -------------------------
|       |       |   |   |       |   |           |   |   |       |
-   -   -   -   -   -   -   -   ---------------------------------
|       |               |           |   |           |   |       |
-   -   -   -   -   -   -   -------------------------------------
|   |       |   |           |   |   |               |           |
-   -   -   -   -   -   -   -   ---------------------------------
|           |       |   |               |           |       |   |
-   -   -   -   -   -   -----------------------------------------
|           |   |                       |   |           |       |
-   -   -   -   -   -   -----------------------------------------
|       |   |       |           |       |           |       |   |
-   -   -   -   -   -   -   -   -   -----------------------------
|           |   |   |   |           |               |   |   |   |
-   -   -   -   -   -   -   -   -   -----------------------------
|   |   |       |   |   |   |           |   |   |   |       |   |
-   -   -   -   -   -   -   -   -   -   -   -   -   -------------
|       |       |   |       |   |       |               |       |
-   -   -   -   -------------------------------------------------
|                           |           |   |       |       |   |
-   -   -   -   -   -   -   -------------------------------------
|   |   |               |                       |   |       |   |
-   -   -   -   -   -   -   -------------------------------------
|   |           |   |       |           |       |       |   |   |
-   -   -   -   -   -   -   -   -   -   -   -   -----------------
|       |   |           |   |           |   |       |   |       |
-   -   -   -   -   -   -----------------------------------------
|   |           |           |       |   |   |   |       |       |
-   -   -   -   -   -   -   -   -   -   -   -   -   -------------
|   |   |   |   |   |   |       |       |   |       |           |
-   -   -   -   -   -   -----------------------------------------
|               |   |   |   |       |       |   |       |       |
-   -   -   -   -   -   -   -   -   -----------------------------
|       |               |       |       |   |       |       |   |
-   -   -   -   -   -   -   -   ---------------------------------
|       |   |           |           |   |       |       |       |
-   -   -   -   -   -   -   -   ---------------------------------
|       |   |       |           |       |   |       |           |
-   -   -   -   -   -   -   -   -   -----------------------------
|   |       |           |   |   |   |           |       |       |
-   -   -   -   -   ---------------------------------------------
|       |       |       |                       |               |
-   -   -   -   -   -   -   -   ---------------------------------
|       |   |   |               |   |   |   |   |       |       |
-   -   -   -   -   -   -   -   -   -----------------------------
|       |   |       |           |   |   |   |   |       |   |   |
-   -   -   -   -   -   -   -   -   -   -------------------------
|   |       |           |       |           |   |       |   |   |
-   -   -   -   -   -   -   -   -   -----------------------------
|       |   |   |   |       |       |   |   |       |           |
-   -   -   -   -   -   -   -------------------------------------
|       |           |   |           |           |   |   |       |
-   -   -   -   -   -   -   -   -   -   -   -   -----------------
|       |   |   |       |   |           |           |   |   |   |
-   -   -   -   -   -   -   -------------------------------------
|           |       |       |           |           |   |   |   |
-   -   -   -   -   -   -   -   ---------------------------------
|       |   |                   |           |   |   |   |   |   |
-   -   -   -   -   -   -   -   -   -   -------------------------
|       |   |   |       |       |       |   |   |       |       |
-   -   -   -   -   -   -   -   ---------------------------------
|                   |               |                   |   |   |
-   -   -   -   -   -   -   -------------------------------------
|       |       |   |       |   |       |   |       |           |
-   -   -   -   -   -   -   -   ---------------------------------
|       |           |           |   |       |       |   |       |
-   -   -   -   -   -   -   -   -   -----------------------------
|           |   |       |       |   |               |   |       |
-   -   -   -   -   -   -   -   ---------------------------------
|   |           |       |   |       |           |   |   |   |   |
-   -   -   -   -   -   -----------------------------------------
|   |                   |   |   |       |           |       |   |
-   -   -   -   -   -   -   -   ---------------------------------
|       |       |   |               |           |       |       |
-   -   -   -   -   -   -   -   ---------------------------------
|   |               |   |   |       |       |   |   |       |   |
-   -   -   -   -   -   -   -   -   -----------------------------
|                           |   |           |       |   |       |
-   -   -   -   -   -   -   -   ---------------------------------
|   |               |   |           |   |   |   |           |   |
-   -   -   -   -   -   -----------------------------------------
|           |       |   |       |       |               |       |
-   -   -   -   -   -   -   -   -   -----------------------------
|       |       |       |       |       |       |   |       |   |
-   -   -   -   -   -   -   -   -   -----------------------------
|                   |               |           |               
-----------------------------------------------------------------
